________________________________________
|--------------------------------------|
|--------------------------------------|
|--------------------------------------|
|--------------------------------------|
|-----------*@*---------***------------|
|---------**|-|*-------*|-|**----------|
|--------*|----|*-----*|----|*---------|
|--------|------|*---*|------|---------|
|-------*|-------|---|-------|*--------|
|-------|-----------*|--------|--------|
|-------|---------------------|--------|
|-------|*-------------------*|--------|
|--------|-------------------|---------|
|--------|*-----------------*|---------|
|---------|--M--------------|----------|
|---------|*---------------*|----------|
|----------|*-------------*|-----------|
|-----------|*-----------*|------------|
|------------|*---------*|-------------|
|-------------|*-------*|--------------|
|--------------|*-----*|---------------|
|---------------|*----|----------------|
|----------------|*--------------------|
|--------------------------------------|
|-----------------------------------M--|
|----------------------*******#*********
|--------------------------------------|
|------H-------------------------------|
******************---------------------|
|--------------------------------------|
|--------------------------------------|
|--------------------------------------|
****************************************