________________________________________
|--------------------------------------|
|--------------------------------------|
|--------------------------------------|
|--------------------------------------|
|--------M-----------------------------|
|--------------------------------------|
************************---------------|
|--------------------------------------|
|--------------------------------------|
|--------------------------------------|
|--------------------------------------|
|--------------------------------------|
|---------------************************
|--------------------------------------|
|--------------------------------------|
|---------H----------------------------|
|--------------------------------------|
************************---------------|
|--------------------------------------|
|--------------------------------------|
|--------------------------------------|
|-----------------------------M--------|
|---------------************************
|--------------------------------------|
|--------------------------------------|
|--------------------------------------|
|--------------------------------------|
************************---------------|
|--------------------------------------|
|----------M---------------------------|
|--------------------------------------|
|--------------------------------------|
****************************************