________________________________________
|--------------------------------------|
|--------------------------------------|
|--------------------------------------|
|-----M---------------------------**#***
|---------------------------------|----|
****@****-------------------------|----|
|-------|--------------------******----|
|-------|--------------------|---------|
|-------|--------------------|---------|
|-------*********-------******---------|
|---------------|----------------------|
|---------------|----------------------|
|---------------|----------------------|
******----------*********--------------|
|----|---------------------------------|
|----|-------------------------*********
|----**@***--------------------|-------|
|---------|--------------------|-------|
|---------|-----------------M--|-------|
|---------******-------*********-------|
|----------------------|---------------|
|----------------------|---------------|
|----------------------|----------******
******---------*********----------|----|
|----|----------------------------|----|
|----|-----------------------******----|
|----******------------------|---------|
|---------|------------------|---------|
|---------|-------------**#***---------|
|---------******-----------------------|
|--------------------------------------|
|--H-----------------------------------|
****************************************